--SETTINGS--

Website title = Sfoda - English Dictionary
Language A = Sfoda
Language B = English
Exonym A = Sfodan
Exonym B = English

--PARTS OF SPEECH--

adj = adjective
adv = adverb
conj = conjunction
interj = interjection
n = noun
nf = feminine noun
nm = masculine noun
nn = neuter noun
num = number
prep = preposition
pron = pronoun
v = verb

--A TO B DICTIONARY--

@ stal /stal/ n: man

@ strul /stryl/
v:
# say, tell
* I say he's an idiot - chu strul qu ik gak
* he says things - ik strul wa
# notify, inform
n:
# speech
* I corrected his speech - chu colik iks strul
Etymology: Optional 
Derived_terms: Optional

@ stuh /stux/ n: something


--B TO A DICTIONARY--
